1111111111111
10010000000C1
1000011111001
1000110000001
10P10000000C1
1000011111001
1000110000001
10010000000C1
1000011111001
1000110000001
10010000000C1
1001E11111001
10001CC100001
10010CC1000C1
1000011111001
1111111111111
